

SO             ./textures/mossystone.xpm
F 110,110,110



EA                           ./textures/wood.xpm


C    0,0,0

WE                                    ./textures/greystone.xpm

NO                                                       ./textures/beigerock.xpm
        111111111111111111111111
        1 11000000110000000000001
        1111000001110000000000001
        1001000000000000000000001
111111111011000001110000000000001
100000000000000001110111110111111
11110111111111011100000010001
11110111111111011101010010001
11000000110101011100000010001
10000000000000001100000010001
10000000000000001101010010001
11000001110101011111011110N0111
11110111 1110101 101111010001
11111111 1111111 111111111111